size: 24.000000 x 24.000000
15 19 13 18 11 18 9 17
9 17 9 13 9 9 9 5
9 5 11 6 13 6 15 7
15 7 15 11 15 15 15 19
15 19 15 19 15 19 15 19
20 3 20 3 20 3 20 3
20 3 19 4 17 4 15 5
15 5 13 4 11 4 9 3
9 3 7 4 5 4 3 5
3 5 3 5 3 5 3 5
3 5 3 10 3 15 3 20
3 20 3 21 3 21 4 21
4 21 4 21 4 21 4 21
4 21 5 20 7 20 9 19
9 19 11 20 13 20 15 21
15 21 17 20 19 20 21 19
21 19 21 19 21 19 21 19
21 19 21 14 21 9 21 4
21 4 21 3 21 3 20 3
20 3 20 3 20 3 20 3
