size: 24.000000 x 24.000000
12 12 11 12 10 10 10 9
10 9 10 8 11 6 12 6
12 6 13 6 14 8 14 9
14 9 14 10 13 12 12 12
12 12 12 12 12 12 12 12
12 2 8 2 5 5 5 9
5 9 5 14 12 22 12 22
12 22 12 22 19 14 19 9
19 9 19 5 16 2 12 2
12 2 12 2 12 2 12 2
