size: 24.000000 x 24.000000
18 17 18 17 17 16 16 16
16 16 16 16 15 16 15 16
15 16 15 15 15 14 15 13
15 13 15 12 15 12 14 12
14 12 12 12 10 12 8 12
8 12 8 11 8 11 8 10
8 10 9 10 9 10 10 10
10 10 11 10 11 10 11 9
11 9 11 8 11 8 11 7
11 7 12 7 12 7 13 7
13 7 14 7 15 6 15 5
15 5 15 5 15 5 15 5
15 5 18 6 20 9 20 12
20 12 20 14 19 16 18 17
18 17 18 17 18 17 18 17
11 20 7 19 4 16 4 12
4 12 4 11 4 11 4 10
4 10 6 12 7 13 9 15
9 15 9 15 9 16 9 16
9 16 9 17 10 18 11 18
11 18 11 19 11 19 11 20
11 20 11 20 11 20 11 20
12 2 6 2 2 6 2 12
2 12 2 18 6 22 12 22
12 22 18 22 22 18 22 12
22 12 22 6 18 2 12 2
12 2 12 2 12 2 12 2
